R 1 1
NO images/tile092.xpm
SO images/tile093.xpm
WE images/tile124.xpm
EA images/tile104.xpm
S images/slugma.xpm
F 220,100,0
C 225,30,255
            111111111   11111111
            100000000111000000001
            100111000011120000211
            100001000000001110001
111111111111011000000000000000001
10000000000001000010000000111111
100000000011122111100010000000001
1000000000020000020000011100000011111111
11111111101000000000001000000000000001
11111111101000000000001000000000000001
11111111101000000000001000000000000001
1111111110100002220122220000001111111
1111111110100000000000100000001111111
11111111101000000000001000000000000001
11111111101000000000001000000000000001
1111111110100000000000100001000000001
1111111110100000000000100000011111110111111111
111111111020000000000010000001      11000000001
1002000002000000200000000000011111111 11111111
1110000000012000002010001000000011111
1110000000012000002010001000000011111   N1
1110000000012000002010001000000011111   1
111000000001200000201000100000001111111111111
1110000000012000002010001000000022222222222221
101
 11111111111 111111111111111111111111111111111
